11111111111111111
10000000000000P01
10000111000000001
10000101100111111
1E000100000C00001
11111111111111111