11111111111111111
10000000000000P01
10000111000000001
10000101100111111
10E001000000000C1
111111111111111111